WWWWWWWWWWWW
WWWWFFFFWWWW
WWPFFCFFFDWW
WWFFWWWWFFWW
WFFFFFFFFFFW
WFCFWWWWFCFW
WFFFDWWDFFFW
WFFFFFFFFFFW
WWFFWWWWFFWW
WWDFFFCFFFWW
WWWWFFFFWWWW
WWWWWWWWWWWW