WWWWWWWWWWWW
WWFFWDWFFWWW
WWFFFFFCFWWW
WWFFFFFFFWWW
WWFFWCWWWWWW
WWDFFFDWFFFW
WFFFWFFCFFFW
WFFFFFWFFFFW
WWFFFFDFFPFW
WWWFFFFFFFFW
WWWWWWWWWWWW