WWWWWWWWWWWW
WWWFFFFWWWWW
WWPFFFFWWWWW
WFFFFFCFFFDW
WFWCWWCWWWWW
WFFFFFFFDWWW
WFWWWWFWWWWW
WFFFFWDWWWWW
WFFCFWWWDWWW
WWFFFFFFFFWW
WWWFFFFFFFWW
WWWWWWWWWWWW