WWWWWWWWWWWW
WFFFWFPFFFDW
WFFFFCFWFFFW
WDFFWFCWFWFW
WWWWWFFWFWWW
WWWWFFFCCFFW
WWWWFFFWFFFW
WFWWWFCWFFFW
WFDWFFFWFFWW
WFFFFFFFFWWW
WFFFFFDWDWWW
WWWWWWWWWWWW