WWWWWWWWWWWW
WFFFFPFFFFFW
WFCFFFFFFFFW
WWWWWWWWWFFW
WFFFFFFWWFFW
WCFFFFFWWFFW
WFFFWWFWWFFW
WFFFWWDWWFFW
WDWFWWWWWFFW
WWFFFFFFFFFW
WWWFFFFFFFFW
WWWWWWWWWWWW